NO ./textures/north.xpm
SO ./textures/south.xpm
WE ./textures/west.xpm
EA ./textures/east.xpm
F 100,150,150
C 50,50,50

111111111
100000001
100011111
100000001
100N00001
100001001
100001001
100001001
111111111

















