NO ./path_to_north.xpm
SO ./path_to_south.xpm
WE ./path_to_west.xpm
EA ./path_to_east.xpm
F 220,100,0
C 225,30,0

1111111
10N0001
1011101
1000001
1111111