NO ./textures/north.xpm
SO ./textures/south.xpm
WE ./textures/west.xpm
EA ./textures/east.xpm

F 220,100,0
C 225,30,0

11111
1001
1001
11111
100001
10001011
10S000001
10000001
1000001
100001
11111