NO ./textures/north.xpm
SO ./textures/south.xpm
WE ./textures/west.xpm
EA ./textures/east.xpm

F 182,10,11
C 180,31,143

11111
1001
1001
11111
100001
10001011
1000S001
10010001
1000001
100001
11111